AHMEDABAD JN - ADI
AGRA CANTT - AGC
AJMER JN - AII
AMRITSAR JN - ASR
AURANGABAD - AWB
BHUBANESWAR - BBS
BAREILLY - BE
BIKANER JN - BKN
BANARAS - BSBS
CHENNAI EGMORE - MS
PRAYAGRAJ JN. - PRYJ
H NIZAMUDDIN - NZM
MATHURA JN - MTJ
MYSURU JN - MYS
NEW DELHI - NDLS
H SAHIB NANDED - NED
NAGPUR - NGP
NEW JALPAIGURI - NJP
NASHIK ROAD - NK
RANCHI - RNC
SALEM JN - SA
KSR BENGALURU - SBC
SECUNDERABAD JN - SC
SEALDAH - SDAH
PATNA JN - PNBE
PANVEL - PNVL
PUNE JN - PUNE
PURI - PURI
RAIPUR JN - R
RAJAHMUNDRY - RJY
DELHI - DLI
INDORE JN BG - INDB
BHOPAL JN - BPL
VADODARA JN - BRC
JAMMU TAWI - JAT
JABALPUR - JBP
VARANASI JN - BSB
DADAR - DR
V LAKSHMIBAI - VGLB
BILASPUR JN - BSP
BORIVALI - BVI
ERODE JN - ED
ERNAKULAM TOWN - ERN
ERNAKULAM JN - ERS
JAIPUR - JP
JODHPUR JN - JU
KALYAN JN - KYN
VIJAYAWADA JN - BZA
KANNUR - CAN
COIMBATORE JN - CBE
LUDHIANA JN - LDH
CHANDIGARH - CDG
GUWAHATI - GHY
KACHEGUDA - KCG
LUCKNOW NE - LJN
LUCKNOW NR - LKO
GORAKHPUR JN - GKP
KHARAGPUR JN - KGP
KOZHIKKODE - CLT
GUNTUR JN - GNT
MADGAON - MAO
MGR CHENNAI CTL - MAS
KANPUR CENTRAL - CNB
KRISHNARAJAPURM - KJM
MADURAI JN - MDU
MUZAFFARPUR JN - MFP
GWALIOR - GWL
GHAZIABAD - GZB
RANI KAMALAPATI - RKMP
DD UPADHYAYA JN - DDU
DELHI S ROHILLA - DEE
KOTA JN - KOTA
KATPADI JN - KPD
HARIDWAR JN - HW
HOWRAH JN - HWH
HYDERABAD DECAN - HYB
UDAIPUR CITY - UDZ
UJJAIN JN - UJN
AMBALA CANT JN - UMB
VAPI - VAPI
KOLKATA - KOAA
ANAND VIHAR TRM - ANVT
VISAKHAPATNAM - VSKP
MUMBAI CENTRAL - MMCT
C SHIVAJI MAH T - CSMT
SURAT - ST
YESVANTPUR JN - YPR
SOLAPUR JN - SUR
TATANAGAR JN - TATA
TAMBARAM - TBM
THRISUR - TCR
BANDRA TERMINUS - BDTS
TIRUNELVELI - TEN
THANE - TNA
TIRUCHCHIRAPALI - TPJ
TIRUPATI - TPTY
LOKMANYATILAK T - LTT
TRIVANDRUM CNTL - TVC
SSS HUBBALLI JN - UBL
RAJENDRANAGAR T - RJPB
MUMBAI CENTRAL - BCT